####################################################################################################
#..................................................................................................#
#..................................................................................................#
#..................................................................................................#
#..................................................................................................#
#..................................................................................................#
#..................................................................................................#
#..................................................................................................#
#..................................................................................................#
#..................................................................................................#
#..................................................................................................#
#..................................................................................................#
#..................................................................................................#
#..................................................................................................#
#..................................................................................................#
#..................................................................................................#
#..................................................................................................#
#..................................................................................................#
#..................................................................................................#
#..................................................................................................#
#..................................................................................................#
#..................................................................................................#
#..................................................................................................#
#..................................................................................................#
#..................................................................................................#
#..................................................................................................#
#..................................................................................................#
#..................................................................................................#
#..................................................................................................#
#..................................................................................................#
#..................................................................................................#
#..................................................................................................#
#..................................................................................................#
#..................................................................................................#
#..................................................................................................#
#..................................................................................................#
#..................................................................................................#
#..................................................................................................#
#..................................................................................................#
#..................................................................................................#
#..................................................................................................#
#..................................................................................................#
#..................................................................................................#
#..................................................................................................#
#..................................................................................................#
#..................................................................................................#
#..................................................................................................#
#..................................................................................................#
#..................................................................................................#
#..................................................................................................#
#..................................................................................................#
#########---########################################################################################
#########...########################################################################################
