##################################################################################
##################################################################################
##..............................................................................##
##..............................................................................##
##..............................................................................##
##..............................................................................##
##..............................................................................##
##................................................................................
##@@@#####.......######...........................................................
##.......#########................................................................
##..................................--------.-------.-------.--------.-----.....##
##.....................................===.....===.....===.....=.=.....===......##
##......................................==.....===.....===.....===.....===......##
##.....#.......########................===.....===.....==......=.=.....==.......##
##......#......##........###...........==......=.=.....===......==.....===......##
##.......#.....#........#..............===.....===.....===.....===.....===......##
##........#....#.......#...............===.....===.....===.....===.....===......##
##.........#..........#................===.....===.....=.=.....===......==......##
##.........#######..##.....####........===.....===.....===.....===.....===......##
##........................#............=.=.....=.=.....===.....==......==.......##
##.......................#.............===.....===.....===.....===.....===......##
##......................#..............===.....===.....==......===.....===......##
##........##############.....##........===......==.....===.....===.....===......##
##..........................##..........==.....===......==.....=.=.....=.=......##
##.........................##..........===.....===.....===.....===.....===......##
##........................##.........-------.-------..------..------...-----....##
##@@@######################............===.....===.....===.....===.....===......##
##....#####.######.##..................=.=.....=.=.....===.....===.....=.=......##
##.....#..###...###.#.................=.===...===.=...=.===...=..==...=.===.....##
##......##.####.#.###................=======.=======.==.=.==.====.==.=======....##
##.......###..###.##########....##################################################
##.........###..###.###.................#.........###########.######.######.######
##...........###..####..................#...........####....##..###.###..#.###..##
##.............####.#...................#.............######################....##
##...............####...................#.......................................##
##.................#....................#.......................................##
##......................###~~~~~~~~~~~~~#~~~~~#.................................##
##.....................###~~~~~~~~~~~~~~#~~~~~#.................................##
##....................###~~~~~~~~~~~~~~~#~~~~~#.................................##
##...................##~~~~~~~~~~~~~~~~~#~~~~~#.......##.............###........##
##..................##~~~~~~~~~~~~~~~~~~#~~~~~#.....##..###........##...##......##
##.................##~~~~~~~~~~~~~~~~~~~#~~~~~#....#.......##...###.......###...##
##................###~~~~~~~~~~~~~~~~~~~#~~~~~#...#..........###................##
##...............####~~~~~~~~~~~~~~~~~~~#~~~~~#.##.............................###
##..............###.#~~~~~~~~~~~~~~~~~~~#~~~~~##..............................#.##
##.............###.##~~~~~~~~~~~~~~~~~~##~~~~~#.................................##
##............#######~~~~~~~~~~~~~~~~~###~~~~~#.................................##
##...........###..###~~~~~~~~~~~~~~~#####~~~~~#.....######################......##
##..........####.##.#~~~~~~~~~~~~~~#~~~~~~~~~~#..........................####...##
##.........##..######~~~~~~~~~~~~~#~~~~~~~~~~~#.............................######
##@@@################~~~~~~~~~~~~~~~~~~~~~~~~~#.................................##
##.........###.##..##~~~~~~~~~~~~~~~~~~~#######.................................##
##...........###..#.###########################.................................##
##.............######.................##############################..############
##...............##.#.................#......................................#..##
##.................##..################......................................#..##
##..................#....................###########.#########################..##
##..................#########..###########.........#.....................#......##
##..................#......................##..###.#########.###############.#####
##..................########################.....#..............................##
##..................#............................#################################
##........#@@@###############..###################..............................##
##........#......................................#..............................##
##........#......................................#..............................##
##........#...............########################..............................##
##.......##...#############.....................................................##
##.......##.....................................................................##
##.......##.....................................................................##
##.......##.....................................................................##
##.......##..................................................................#@@##
##@@@###############................................#####################..###....
##.....###...................########################.........#..............#....
##.....###...................#......................#.........#..............#....
##.....###..........##########......................#..######.#..............#..##
##.....###..........#................###..###########..#....#.#############..#..##
##...--###..........#................#..............#..#....#................#..##
##.....###..........#......#..########..............#..#....#................#..##
##.....###.....#...........#.........#..##########..#..###..########..########..##
##.....###.....#...........#.........#..#..............#........................##
##.....###.....#...........#.........#..#..............#........................##
##@@@#############################################################################
##@@@#############################################################################
