######################################################........#.....#
#.............................................................#.....#
#..........................................................####...###
#.............................................................#.....#
#.............................................................#.....#
######@@@####################.............................#######...#
#......................#....#.................................#.....#
#.....................##....####..............................#.....#
#.....................#.....#............................######...###
#...........................#.....................########..........#
######@@@##.................############~~~~~~~~~~#.................#
#.........#...........#~~~~~#~~~~~~~~~~~~~~~~~~~~~#~~~~~~~~~~~~~~####
#.........#...........##~~~~#~~~~~~~~~~~~~~~~~~~~~#~~~~~~~~~~~~~~~~~#
#.........###..........#~~~~#~~~~~~~~~~~~~~~~~~~~~#~~~~~~~~~#########
#.........#............#~~~~#~~~###################~~~~~~~~~~~~~~~~~#
#.........#............#~~~~#~~~~~~~~~~~~~~~~~~~####~~~~~~~~~~~~~~~~#
#....##########........#~~~~#~~~~~~~~~~~~~~~~~~~~####~~~~~~~~~~~~~~~#
#~~~##~~~~#~~~##~~~~~~~#~~~~#~~~~~~~~~~~~~~~~~~~~~####~~~~~~~~~~~~~~#
#~~~~~~~~~#~~~~~~~~~~~~#~~~~##~~~~~~~~~~~~~~~~~~~~~####~~~~~~~~~~~~~#
#~~~~~~~~~#~~~~~~~~~~~~#~~~~~###########~~~~~~~~~~~~############~~~~#
#~~~~~~~~~#~~~~~~~~~~~~#~~~~~~~~~~~~~~~~~~~~~~~~~~~~~###########~~~~#
#~~~~~~~~~#~~~~~~~~~~~~#~~~~~~~~~~~~~~~~~~~~~~~~~~~~~~~~~~~~~~~~~~~~#
#~~~~~~~~~#~~~~~~~~~~~~##~~~~~~~~~~~~~~~~~~~~~~~~~~~~~~~~~~~~~~~~~~~#
#~~~~~~~~~#~~~~~~~~~~~~~##~~~~~~~~~~~~~~~~~~~~~~~~~~~~~~~~~~~~~~~~~~#
#~~~~~~~~~#~~~~~~~~~~~~~~###############~~~~~~~~~~~~~~~~~~~~~~~######
#~~~~~~~~~~~~~~~~~~~~~~~~~~~~~~~~~~~######~~~~~~~~~~~~~~~~~~~########
#~~~~~~~~~~~~~~~~~~~~~~~~~~~~~~~~~~~~##############~~~~##############
#~~~~~~~~~~~~~~~~~~~~~~~~~~~~~~~~~~~~~###############################
#~~~~~~~~~~~~~~~~~~~~~~~~~~~~~~~~~~~~~~##############################
##~~~~~~#############################################################
##~~~~~~#############################################################
