#########################################################################################@@@##########
#########################################################################################@@@##########
##.....................#........................#........................#..........................##
##.....................##.......................#........................#...............---........##
##......................#.......................#........................#...............===........##
##......................#.......................#........................#...............===........##
#######.................#.......................#........................#................--........##
##......................#.......................#........................#...............===........##
##......................#.......................#........................#...#...........===........##
##..............##################......###################.......############...........=.=........##
##.......................................................................................===........##
##.......................................................................................===........##
##..............................................................---......................===........##
##.....-----......................................................---....................===........##
##.....................................---------.................................---.....===........##
##.............................................................................---.......===........##
##.....................--------..............................................---.........===........##
.........................................................................................--.........##
..........................................................------------...................===........##
.........................................................................................===........##
##.......--------........................................................................===........##
##.......========........................................................................===........##
##.......========........................................................................===........##
##.......========........................................................................===........##
##.......========........................................................................===........##
##.......========........................................................................===........##
##.......========........------------.......--------.....................................===........##
##.......========........============.......========.....................................===........##
##.......========........============.......========......................................--........##
##.......========........============.......=.======.....................................===........##
##.......===.====........============.......=.===..=.....................................===........##
##.......===.====........============.......==.==.==.....................................===........##
##.......===.====........====.=======.......========........------------.................===........##
##.......===.====........==..========.......========........============.................===........##
##----...===.====........===.========.......========........============.................===........##
##.......===.=.==........======..====.......========........============.................--.........##
##.......===.=.==........======..====.......===.====........============.................===........##
##.......=====.==........======..====.......===.====........===.========.................===........##
##.......===.=.==........======..====.......===.====........===.========.................===........##
##.......===...==........======..====.......===.====........===..=======.....#########...===.......###
##.......===..===........======...===.......===.====........====..======.................===.......###
##.......==...===........======...===.......==...===........===....=...=.................===.......###
##.......==.=.===........======...===.......==...===........=.=.========.................===.......###
##.......==...===........===.==...===.......===..===........=.=====...==.................===.......###
##.......==..====........===.==...===.......===..===........=...=....===..............################
##.......==.=====........===.==...===.......===..===........==..=.====.=.................===.......###
##.......==.=====........===..=...===.......===..===........==..=.====.=.................===.......###
.........==.=====........===..=...===.......===..===........==..=.=..=.=.................===.......###
.........==.=====........===..=...===.......===....=........==.==.=..=.=.................===.......###
.........========........=....=..====.......===..=.=........==.=.==..=.=.................===.......###
##.......========........=....=..====.......===.==.=........======.===.=.................===.......###
##....------=====........=....=..====.......===...==........===========----------........==........###
##....=====----==........=....=..====.......===..===........=====================........===.......###
##....========----......-----------==....------=====........======.==============........===.......###
##....============......=============....=====----==........=======.=============........===.......###
##....============......=============....========----.......=======..=======.====........=.=.......###
##....============......=============....============.......===============..====........===.......###
##....=======.====......=============....============....----------.=====.=...===........===.......###
##....=======..===......=============....==.=========....==========..====.=...===........===.......###
##....========.===......=============....==..=====---....=.========....==.=...===.........==.......###
##@@@@@@@@#===..==......===..======.=....===..=======....==.=======....==.==..===........===........##
##........#====.==......====.======.=....====.=======....==========....==..=..===........===........##
##........##======......====.======.=....====..====###########====#####========################.....##
##........#=======......===========.=....=====.======....==========..###=========........===........##
##........#=======......===========.=....============....======.===..####========........===........##
##........#####===..##########====###########====###########==..=#########.======........===.......###
##........#===#===..#...=====#====#.=....===#====#===....==#==.==#=..######.=====........===......####
##........#===#===..#...===.=#=.==#.=....===#====#===....==#=====#=..#######.====........==......#####
##........#===#===..#...===.=#=.==#.=....===#====#===....==#=====#=..########.===........===....######
##........#===#===..#...===.=#=.==#.=....===#===.#.==....==#=====#=..#########===........===...#######
##........#=======......===.=======.=....=======..===....==========..##########==........===..########
##........#=======......===========.=....============....==========..###########=........===.#########
#########################################################################################---##########
#########################################################################################...##########
