##########...###############################################
.............................#.............................#
.............................#.............................#
.............................#.............................#
###########..................#.............................#
.........##########################........................#
.................................######....................|
.....................................#######...............|
.........................................#######...........|
##.........................................................#
#..........................................................#
|.......#..................................................#
|.......#..................................................#
|.......#..................................................|
|.......###############....................................|
|.....................########.............................|
#..........................................................#
...........................................................#
...........................................................#
...............................####################..###...#
#........#######################.........#.............#@@@#
#........#.....................#.........#.............#....
##########.....................#..######.############..#....
#................###..##########..#....#...............#....
#................#.............#..#....##..............#..##
#......#..########.............#..#.....########..######..##
.......#.........#..#########..#..###.....................##
.......#.........#..#.............#.......................##
.......#.........#..#.............#.......................##
############################################################
