######################################################........#.....#
#.............................................................#.....#
#..........................................................####...###
#.............................................................#.....#
#.............................................................#.....#
#############################.............................#######...#
#......................#....#.................................#.....#
#.....................##....####..............................#.....#
#.....................#.....#............................######...###
#...........................#.....................########..........#
##########..................############~~~~~~~~~~#.................#
#........#............#~~~~~#~~~~~~~~~~~~~~~~~~~~~#~~~~~~~~~~~~~~####
#........#............##~~~~#~~~~~~~~~~~~~~~~~~~~~#~~~~~~~~~~~~~~~~~#
#........###...........#~~~~#~~~~~~~~~~~~~~~~~~~~~#~~~~~~~~~#########
#........#.............#~~~~#~~~###################~~~~~~~~~~~~~~~~~#
#........#.............#~~~~#~~~~~~~~~~~~~~~~~~~####~~~~~~~~~~~~~~~~#
#....#########.........#~~~~#~~~~~~~~~~~~~~~~~~~~####~~~~~~~~~~~~~~~#
#~~~##~~~#~~~##~~~~~~~~#~~~~#~~~~~~~~~~~~~~~~~~~~~####~~~~~~~~~~~~~~#
#~~~~~~~~#~~~~~~~~~~~~~#~~~~##~~~~~~~~~~~~~~~~~~~~~####~~~~~~~~~~~~~#
#~~~~~~~~#~~~~~~~~~~~~~#~~~~~###########~~~~~~~~~~~~############~~~~#
#~~~~~~~~#~~~~~~~~~~~~~#~~~~~~~~~~~~~~~~~~~~~~~~~~~~~###########~~~~#
#~~~~~~~~#~~~~~~~~~~~~~#~~~~~~~~~~~~~~~~~~~~~~~~~~~~~~~~~~~~~~~~~~~~#
#~~~~~~~~#~~~~~~~~~~~~~##~~~~~~~~~~~~~~~~~~~~~~~~~~~~~~~~~~~~~~~~~~~#
#~~~~~~~~#~~~~~~~~~~~~~~##~~~~~~~~~~~~~~~~~~~~~~~~~~~~~~~~~~~~~~~~~~#
#~~~~~~~~#~~~~~~~~~~~~~~~###############~~~~~~~~~~~~~~~~~~~~~~~######
#~~~~~~~~~~~~~~~~~~~~~~~~~~~~~~~~~~~######~~~~~~~~~~~~~~~~~~~########
#~~~~~~~~~~~~~~~~~~~~~~~~~~~~~~~~~~~~##############~~~~##############
#~~~~~~~~~~~~~~~~~~~~~~~~~~~~~~~~~~~~~###############################
#~~~~~~~~~~~~~~~~~~~~~~~~~~~~~~~~~~~~~~##############################
##~~~~~~#############################################################
##~~~~~~#############################################################
