##############################################
##############################################
....................................#.......##
....................................#.......##
##..................................#..#######
#...................................#.......##
#...................................#.......##
#...................................#.........
#...................................#.........
################...####...############........
#....................................#......##
#....................................##@@@####
#...........................................##
#..............------------.................##
#...........................................##
#...........................................##
#...........................................##
#...........................................##
#########################################---##
#________________________________________...__
