###########################
###########################
...........................
...........................
.........##################
##.......#........#.......#
##.......#........#.......#
##.......#........#.......#
##.......#........#...#...#
##.......#........#...#...#
###@@@@@#######.......#...#
##.......#............#...#
##.......#............#...#
##.......#............#...#
##.......#............#...#
##.......#...---..#####...#
##.......#........#...#...#
##.......#........#.......#
##.......#........#.......#
##.......#........#.......#
##.......#...#######@@@####
##.......#........#.......#
##.......#........#.......#
##.......#........#.......#
##.......#........#.......#
##.......#--------#-------#
##.......#........#.......#
