##....###############################
#....................................
#....................................
#....................................
#....................................
#....................................
#####################################
#####################################
