#.......#############################
#.......#............#..............#
#.......#............#.........###..#
#.......#............#..########....#
######..#----#########..#..#........#
#.......................#..#........#
#.###########.........###.....##..###
#...........########..........#.....#
#######...............#########.....#
#.....######..####..###.............#
#............................######.#
#..###....####################......#
#..#...####...........#.............#
#..#................................#
#..##################....############
#...................................#
######.......############........####
#....#######............#####.......#
#..........#########........#######.#
#..................########.......#.#
#......#..#######.........######..#.#
#......#........#########...........#
###############.........#....######.#
#.............#######...######......#
#...................................#
##----###############################
##....###############################
