#####################################################################################...#########
#####################################################################################...#########
...............#....#..........................................................................##
...............#....#...............................................................-----......##
...............#....#..........................................................................##
##---..........#....##########.................................................................##
##.............#-...............................................................---------......##
##.............#==.....................---...---...---...---...---...---................---....##
############..##--.....................===...===...===...===...===...===.......................##
##.............#===....................--=...===...===...===...===...=--.....................--##
##.............#----...................===...===...===...===...=-=...===.......................##
###..###########.................----..===...=--...===...--=...===...===....................---##
##.............#......---..............===...===...===...===...===...===.......................##
##.............#.......................===...===...=-=...===...===...===.......................##
##########.....#............-----......===...===...===...===...===...===................----...##
##.............#............=====......===...===...===...===...===...===.......................##
##.......#######............-------....===...===...===...===...===...===.......................##
##.............#..................--...===...===...===...===...===...===........------......---##
##.............#.......................===...===...===...===...===...===.......................##
##.............#.......................===...===...===...===...===...===.......................##
############...#....................#######################################....................##
##.............#.....#~~~~~~~~~~~~~#########################################~~~~~~~~~~~~~~#....##
##.............#.....#~~~~~~~~~~~~~~~~~~~~~~~#####################~~~~~~~~~~~~~~~~~~~~~~~~#....##
##.............#--...#~~~~~~~~~~~~~~~~~~~~~~~~~~~~~~~~~~~~~~~~~~~~~~~~~~~~~~~~~~~~~~~~~~~~#....##
##.............#.....##~~~~~~~~~~~~~~~~~~~~~~~~~~~~~~~~~~~~~~~~~~~~~~~~~~~~~~~~~~~~~~~~~~##....##
####...#########...--###~~~~~~~~~~~~~~~~~~~~~~~~~~~~~~~~~~~~~~~~~~~~~~~~~~~~~~~~~~~~~~~~###....##
##.............#.....####~~~~~~~~~~~~~~~~~~~~~~~~~~~~~~~~~~~~~~~~~~~~~~~~~~~~~~~~~~~~~~####....##
##.............#.....#####~~~~~~~~~~~~~~~~~~~~~~~~~~~~~~~~~~~~~~~~~~~~~~~~~~~~~~~~~~~~#####......
##.............#...########################################################################......
##.............#......................................##.........................................
##-------------#...............................................................................##
##.............#--..............................##############.................................##
##.............#==...........................................................................=.##
##.............#==...........................................................................==##
##.............#==.--.....................................................................--.==##
##-------------#==...........................................................................==##
##.............#==.....------....-----....--.......................--....-----....------.....==##
##.............#==...........................................................................==##
##.............#==............................--...............--............................==##
##.............#==...........................................................................==##
##-------------#==...........................................................................==##
##.............#==................................-----------................................==##
##.............#==...........................................................................==##
##.............#==...........................................................................==##
##.............#==.......................-----....-----------....-----.......................==##
##.............#==...........................................................................==##
##########...###==..........----------...................................----------..........==##
##.............#==...........................................................................==##
##.............#---------.............................................................---------##
##.............#=========.............................................................=========##
##..............-------------------.........................................-------------------##
##..............===================.........................................===================##
#################################################################################################
#################################################################################################
