##@@@###########################################################################
##@@@###########################################################################
#...............................................................................
#...............................................................................
#...............................................................................
#---------....................................................................##
#.............................................................................##
#.............................................................................##
#.............................................................................##
#.............................................................................##
#.........------------......---------------.......------------......-------...##
#.........=.===.=..=..........===..==.==..........===..==.==..........==.===..##
#..........=.======............===..=.=............===.====............==.=...##
#...........==..==...............=..==..............==..==..............==....##
#...........=...==..............==..=...............==..=...............==....##
#...........=....=..............==..==...............=..==..............==....##
#...........==..==..............==..==..............==..==..............==....##
#...........==..==..............=...==..............==...=..............==....##
#............=..==..............==..==..............=...==...............=....##
#...........==..=...............==...=..............==...=..............==....##
#...........==..==..............==..==..............==..==..............==....##
#-..........==..==..............==..==..............==..==..............==....##
#...#~~~~~###########~~~~~~~~~###########~~~~~~~~~##########~~~~~~~~############
#...#~~~~~~#########~~~~~~~~~~~#########~~~~~~~~~~~########~~~~~~~~~~###########
#...#~~~~~~~#######~~~~~~~~~~~~~#######~~~~~~~~~~~~~######~~~~~~~~~~~~##......##
#-..#~~~~~~~~#####~~~~~~~~~~~~~~~#####~~~~~~~~~~~~~~~####~~~~~~~~~~~~~~##.....##
#...##~~~~~~~~###~~~~~~~~~~~~~~~~~###~~~~~~~~~~~~~~~~~##~~~~~~~~~~~~~~~~###...##
#...##~~~~~~~~~~~~~~~~~~~~~~~~~~~~###~~~~~~~~~~~~~~~~~~~~~~~~~~~~~~~~~~~####~~##
#....#~~~~~~~~~~~~~~~~~~~~~~~~~~~~###~~~~~~~~~~~~~~~~~~~~~~~~~~~~~~~~~~~~###~~##
#--..#~~~~~~~~~~~~~~~~~~~~~~~~~~~~###~~~~~~~~~~~~~~~~~~~~~~~~~~~~~~~~~~~~~##~~##
#....##~~~~~~~~~~~~~~~~~~~~~~~~~~~###~~~~~~~~~~~~~~~~~~~~~~~~~~~~~~~~~~~~~~#~~##
#....##~~~~~~~#~~~~~~~~~~~~~~~~~~~~##~~~~~~~~~~~~~~~~~~~~~~~~~~~~~~~~~~~~~~~~~##
#.....#~~~~~~~##~~~~~~~~~~~~~~~~~~~~#~~~~~~~~~~~~~~~~~~#~~~~~~~~~~~~~~~~~~~~~~##
#--...#~~~~~~~###~~~~~~~~~~~~~~~~~~~~~~~~~~~~~~~~~~~~~##~~~~~~~~~~~~~~~~#~~~~~##
#.....##~~~~~~###~~~~~~~~~~~~~~~~~~~~~~~~~~~~~~~~~~~~~##~~~~~~~~~~~~~~~~##~~~~##
#.....##~~~~~~###~~~~~~~~~~~~~~~~~~~~~~~~~~~~~~~~~~~~~##~~~~~~~~~~~~~~~~###~~~##
#......#~~~~~~###~~~~~~~~~~~~~~~~~~~~~~~~~~~~~~~~~~~~~##~~~~~~~~~~~~~~~~###~~~##
#---...#########################################################################
#......#########################################################################
#......#########################################################################
