##################################################
.................................................#
.................................................#
........................................##########
##...............................................#
##...............................................#
##...............................................#
##...............................................#
##...............................................#
##.......................----....................#
######........................................####
##.###........................................##.#
##..##........................................#..#
##...#...........................................#
##...............................................#
##...............................................#
##...............................................#
##...............................................#
##...............................................#
##...............................................#
######........................................####
##.###........................................##.#
##..##........................................#..#
##...#...........................................#
##...............................................#
##...............................................#
##...............................................#
##...............................................#
##...............................................#
##...............................................#
.....................----.....................####
..............................................##.#
..............................................#..#
##...............................................#
##...............................................#
##...............................................#
##...............................................#
##...............................................#
##...............................................#
##...............................................#
##............................................####
##............................................##.#
##............................................#..#
##...............................................#
###..............................................#
####.............................................#
#####............................................#
####.............................................#
###..............................................#
##...................................----........#
##...............................................#
##...............................................#
##...............................................#
##...............................................#
##......................#........................#
##.....................##........................#
##....................###........................#
##...................####........................#
#########################.......................##
#########################......................###
###............................................###
##..............................................##
##...............................................#
##...............................................#
##...............................................#
##...............................................#
##...............................................#
##...............................................#
##...............................................#
##...................................----........#
##...............................................#
##...............................................#
##...............................................#
##...............................................#
##...............................................#
##.......................#.......................#
##.......................##......................#
###......................###.....................#
####.....................####....................#
#####....................#########################
#####....................#########################
####............................................##
###..........----................................#
##...............................................#
##...............................................#
##...............................................#
##...............................................#
##...............................................#
##...............................................#
##...............................----............#
##...............................................#
##...............................................#
##...............................................#
##...............................................#
##.....................#.........................#
##....................##.........................#
##...................###.........................#
##..................####.........................#
########################........................##
########################.......................###
###............................................###
##..............................................##
##...............................................#
##...............................................#
##...............................................#
##...............................................#
##...............................................#
##...............................................#
##...............................................#
##...........----......-----.....----............#
##...............................................#
##...............................................#
##...............................................#
##...............................................#
##...............................................#
##...............................................#
##...............................................#
.......................................###########
.................................................#
.......................................###########
##......................---......................#
##...............................................#
##...............................................#
##...............................................#
##...............................................#
##...............................................#
##...............................................#
##...............................................#
##...............................................#
#####.........................................####
##..###.................---.................###..#
##...............................................#
##...............................................#
##...............................................#
##...............................................#
##...............................................#
##...............................................#
##......------....------...------....------......#
##......======....======...======....======......#
##......======....======...======....======......#
##......======....======...======....======......#
##......======....======...======....======......#
##......======....======...======....======......#
##......======....======...======....======......#
##########==########==#######==########==#########
##......======....======...======....======......#
##......======....======...======....======......#
##......======....======...======....======......#
##......======....======...======....======......#
##################################################
