########################################################################################################
########################################################################################################
...................................................................................................#..##
...................................................................................................#..##
.........#################################################################################.........#..##
##.......#.........#.........#.................#####..........................###........#.........#..##
##.......#.........#.........#..................###............................##........#.........#..##
##.......#.........#.........#...................#..............................#........#.........#....
##.......#.........#.........#...................#..............................#........#.........#....
##.......#.........#....#....#...................#..............................#..#######.........#....
###@@@@@########........#....#######...#.........#............#####.............#..................#@@##
##.......#..............#....#.........#.........#..............................#.....................##
##.......#..............#....#.........#.........#..............................#........###############
##.......#..............#....#.........#.........#..........#########...........#........#............##
##.......#..............#....#.........#.........#..............................#........#............##
##.......#.........######....#.........#.........#..............................#........##@@@@@@##...##
##.......#.........#.........#.........#.........#........#############.........###...............#...##
##.......#.........#.........#.........#.........#..............................#####.............#...##
##.......#.........#.........#.........#.........#..............................#######...........#...##
##.......#.........#.........#.........#.........#.....###################.....####################...##
##.......#...#######@@@#############...#@@@#######....##..............................................##
##.......#.........#.........#.........#.........#---##...............................................##
##.......#.........#.........#.........#.........#...#................................................##
##.......#.........#.........#.........#.........#...#................................................##
##.......#.........#.........#.........#.........#---#................................................##
##.......#.........#.........#.........#.........#...#................................................##
##.......#.........#.........#.........#.........#...#................................................##
##.......#.........#.........#.........#.........#---#................................................##
##.......#.........#.........#.........#.........#...###~~~~~~~~~######~~~~~~~~~######~~~~~~~~~###....##
##.......#.........#.........#.........#.........#.....##~~~~~~~##....##~~~~~~~##....##~~~~~~~##......##
##.......#######...#######.......#############...#---...##~~~~~##......##~~~~~##......##~~~~~##.......##
##.......#.........#...................#.........#.......#######........#######--------#######........##
##.......#.........#...................#.........#....................................................##
##.......#.........#...................#.........#....................................................##
##.......#.........#...................#.........#....................................................##
##.......#.........#.........#.........#.........#........----................----....................##
##.......#.........#.........#.........#.........#........====......=.........====....................##
##.......#.........#.........#.........#.........#........=.=.......==.........===....................##
##.......#.........#.........#.........#.........#=.......==.=.......==.......==.=......=............=##
##.......#.........#.........#.........#.........#==.......===......=.==......=..=......==.=........==##
##.......#...#######...#############@@@#...#######===.....==.=......==.=......====.......===.......===##
##.......#.........#.........#.........#.........#---....------....------....------....------....-----##
##.......#.........#.........#.........#.........#===....======....=.====....======....======....=====##
##.......#.........#.........#.........#.........#=.=....==.===....====.=....==.===....====.=....===.=##
##.......#.........#.........#.........#.........#=.-....--=.==....======....==.===....=.====....==.==##
##.......#.........#.........#.........#.........#===....===.==....--..==....=.---=....=.--==....---==##
##.......#---......#.........#.........#.........#.==....======....===.==....===.==....===.==....=.===##
##.................#---------#---------#---------#=.=....=.====....======....====.=....==.===....==..=##
##.................#.........#.........#.........#===....======....======....======....======....=====##
##.................#.........#.........#.........#---....------....------....------....------....-----##
##.................#.........#.........#..........===....===.==....==.===....==.===....======....==.==##
##.................#.........#.........#..........=.=....====.=....======....======....====.=....====.##
################################################################################@@@#####################
################################################################################@@@#####################
