##########...###############################################
.............................#.............................#
.............................#.............................#
.............................#.............................#
##########...................#.............................#
.........##########################........................#
.................................######....................|
.....................................#######...............|
.........................................#######...........|
...........................................................#
#..........................................................#
|...#####..................................................#
|.......#..................................................#
|.......#..................................................|
|.......###############....................................|
|.....................########.............................|
#..........................................................#
...........................................................#
...........................................................#
...............................####################..###...#
#........#######################.........#.............#@@@#
#........#.....................#.........#.............#....
##########.....................#..######.############..#....
#................###..##########..#....#...............#....
#................#.............#..#....##..............#..##
#......#..########.............#..#.....########..######..##
.......#.........#..#########..#..###.....................##
.......#.........#..#.............#.......................##
.......#.........#..#.............#.......................##
############################################################
