#####################################################################################...#########
#####################################################################################...#########
...............#...............................................................................##
...............#....................................................................-----......##
...............#...............................................................................##
##-............#...............................................................................##
##.............#-...............................................................---------......##
##.............#==.....................---...---...---...---...---...---................---....##
##.............#--.....................===...===...===...===...===...===.......................##
##.............#===....................--=...===...===...===...===...=--.....................--##
##.............#----...................===...===...===...===...=-=...===.......................##
##.............#.................----..===...=--...===...--=...===...===....................---##
##.............#......---..............===...===...===...===...===...===.......................##
##.............#.......................===...===...=-=...===...===...===.......................##
##.............#............-----......===...===...===...===...===...===................----...##
##.............#............=====......===...===...===...===...===...===.......................##
##.............#............-------....===...===...===...===...===...===.......................##
##.............#..................--...===...===...===...===...===...===........------......---##
##.............#.......................===...===...===...===...===...===.......................##
##.............#.......................===...===...===...===...===...===.......................##
##.............#....................#######################################....................##
##.............#.....#~~~~~~~~~~~~~#########################################~~~~~~~~~~~~~~#....##
##.............#.....#~~~~~~~~~~~~~~~~~~~~~~~#####################~~~~~~~~~~~~~~~~~~~~~~~~#....##
##.............#--...#~~~~~~~~~~~~~~~~~~~~~~~~~~~~~~~~~~~~~~~~~~~~~~~~~~~~~~~~~~~~~~~~~~~~#....##
##.............#.....#~~~~~~~~~~~~~~~~~~~~~~~~~~~~~~~~~~~~~~~~~~~~~~~~~~~~~~~~~~~~~~~~~~~~#....##
##.............#...--#~~~~~~~~~~~~~~~~~~~~~~~~~~~~~~~~~~~~~~~~~~~~~~~~~~~~~~~~~~~~~~~~~~~~#....##
##.............#.....#~~~~~~~~~~~~~~~~~~~~~~~~~~~~~~~~~~~~~~~~~~~~~~~~~~~~~~~~~~~~~~~~~~~~#....##
##.............#.....#~~~~~~~~~~~~~~~~~~~~~~~~~~~~~~~~~~~~~~~~~~~~~~~~~~~~~~~~~~~~~~~~~~~~#......
##.............#...########################################################################......
##.............#.................................................................................
##.............#...............................................................................##
##.............#--.............................................................................##
##.............#==...........................................................................=.##
##.............#==...........................................................................==##
##.............#==.--.....................................................................--.==##
##.............#==...........................................................................==##
##.............#==.....------....-----....--.......................--....-----....------.....==##
##.............#==...........................................................................==##
##.............#==............................--...............--............................==##
##.............#==...........................................................................==##
##.............#==...........................................................................==##
##.............#==................................-----------................................==##
##.............#==...........................................................................==##
##.............#==...........................................................................==##
##.............#==.......................-----....-----------....-----.......................==##
##.............#==...........................................................................==##
##.............#==..........----------...................................----------..........==##
##.............#==...........................................................................==##
##.............#---------.............................................................---------##
##.............#=========.............................................................=========##
##..............-------------------.........................................-------------------##
##..............===================.........................................===================##
#################################################################################################
#################################################################################################
