########################################
#.....................................##
#.....................................##
#.....................................##
#.....................................##
#.....................................##
#~~~~~#...............................##
#~~~~~#...............................##
#~~~~~#...-----.....-----.............|#
#~~~~~#...............................|#
#~~~~~#...........................##..|#
#~~~~~#..........................##...##
#~~~~~############################....##
#~~~~~#...............................##
#~~~~~#...............................|#
#~~~~~#...............................|#
#~~~~~#...............................|#
~~~~~~#...............................##
~~~~~~#...............................##
~~~~~~#...............................##
~~~~~~#.....................############
~~~~~~#.....................#.........##
#######....-------....................##
#######...............................##
######................................##
#####.................................##
####................-------...........##
###...................................##
##....................................##
#.....................................##
#..................................#####
#......--------..................###..##
#..............................###....##
#............................###......##
#............................#........##
#.....................................##
#.....................................##
#.....#####..................#........##
#.....#...##.................####.....##
|.....#....###..................########
|.....#......##.......................##
|.............##......................##
|..............##.....................##
|...............#......#.#............##
|.....#........##......#.##...........##
|.....##.......##.....##.###..........##
#......################..########.....##
#.....................................##
#.....................................##
#.....................................##
#..................................#####
#.................................#...##
#................................#....##
#.....................................##
#.....................................##
####......##############################
#.....................................##
#.....................................##
#.....................................##
##########################...###########
