##~~~~~~##############################################################........##
##~~~~~~#...........#........##.............................#........#........##
##~~~~~~#...........#........#..............................#........#........##
##~~~~~~#...........#........#.............................##........#........##
##~~~~~~#~~~~~#.....#.....####.............................##........#####....##
##~~~~~~#~~~~~#.....#.......##.............................#.........#........##
##~~~~~~~~~~~~#.....#........#.............................##........#........##
##~~~~~~~~~~~~#.....#........#..............................#........#........##
##~~~~~~~~~~~~#.....#.......................................##.......#........##
###############.....#..............-----....................##.......#........##
###.................####....................................##..............####
##..................#........................................##...............##
##............#######........................................##...............##
##........######....#.........................................#...............##
##..................#.......##++++++++++##........-----.......................##
##..................#.......##++++++++++##....................................##
##..................#####...##+++++++++###.................................#####
##..................#.......##+++++++++###....................................##
##..................#.......###+++++++++##....................................##
##..................#........#####++++++##....................................##
##+++++++##.........#.........#####++++++............................##+++++++##
##+++++++##.........#...........####+++++...........-----...........###+++++++##
##+++++++##.........######.......####+++++.........................####+++++++##
###########.......................####++++........................##############
###########........................####++++.....................################
###.................................####+++..................................###
##...................................####+++..................................##
##....................................####++..................................##
##............................#############++.................................##
##.....####........##........##........#####++...##........##........####.....##
##+++++++++++++++++##+++++++++#++++++++#####+++++##++++++++##+++++++++++++++++##
##+++++++++++++++++##+++++++++#++++++++#####+++++##++++++++##+++++++++++++++++##
##++++++++++++++++++++++++++++++++++++++++++++++++++++++++++++++++++++++++++++##
##++++++++++++++++++++++++++++++++++++++++++++++++++++++++++++++++++++++++++++##
##++++++++++++++++++++++++++++++++++++++++++++++++++++++++++++++++++++++++++++##
##++++++++++++++++++++++++++++++++++++++++++++++++++++++++++++++++++++++++++++##
##++++++++++++++++++++++++++++++++++++++++++++++++++++++++++++++++++++++++++++##
##++++++++++++++++++++++++++++++++++++++++++++++++++++++++++++++++++++++++++++##
################################################################################
################################################################################
