######################################################################################################
######################################################################################################
#...................................................................................................##
#...................................................................................................##
#...................................................................................................##
#...................................................................................................##
#...................................................................................................##
#...................................................................................................##
#...................................................................................................##
#...................................................................................................##
#...................................................................................................##
#...................................................................................................##
#...................................................................................................##
#...................................................................................................##
#...................................................................................................##
#...................................................................................................##
#...................................................................................................##
#...................................................................................................##
#...................................................................................................##
#...................................................................................................##
#...................................................................................................##
#...................................................................................................##
#...................................................................................................##
#...................................................................................................##
#...................................................................................................##
#...................................................................................................##
#...................................................................................................##
#...................................................................................................##
#...................................................................................................##
#...................................................................................................##
#...................................................................................................##
#...................................................................................................##
#...................................................................................................##
#...................................................................................................##
#...................................................................................................##
#...................................................................................................##
#...................................................................................................##
#...................................................................................................##
#...................................................................................................##
#...................................................................................................##
#...................................................................................................##
#...................................................................................................##
#...................................................................................................##
#...................................................................................................##
#...................................................................................................##
#...................................................................................................##
#...................................................................................................##
#...................................................................................................##
#.....................................................................................................
#.....................................................................................................
#.....................................................................................................
######################################################################################################
