####...#############
##.................#
##.................#
##.................#
##.................#
##-----------------#
##.................#
##.................#
##.................#
##.................#
##-----------------#
##.................#
##.................#
##.................#
##.................#
##-----------------#
##.................#
##.................#
##.................#
##.................#
##.................#
##########...#######
##.................#
##.................#
##.................#
##..................
##..................
##..................
####################
####################
