########################################################################################################
########################################################################################################
......................................................................................................##
......................................................................................................##
......................................................................................................##
##....................................................................................................##
##....................................................................................................##
##......................................................................................................
##......................................................................................................
##......................................................................................................
##....................................................................................................##
##....................................................................................................##
##....................................................................................................##
##....................................................................................................##
##....................................................................................................##
##....................................................................................................##
##....................................................................................................##
##....................................................................................................##
##....................................................................................................##
##....................................................................................................##
##....................................................................................................##
##....................................................................................................##
##....................................................................................................##
##....................................................................................................##
##....................................................................................................##
##....................................................................................................##
##....................................................................................................##
##....................................................................................................##
##....................................................................................................##
##....................................................................................................##
##....................................................................................................##
##....................................................................................................##
##....................................................................................................##
##....................................................................................................##
##....................................................................................................##
##....................................................................................................##
##....................................................................................................##
##....................................................................................................##
##....................................................................................................##
##....................................................................................................##
##....................................................................................................##
##....................................................................................................##
##....................................................................................................##
##....................................................................................................##
##....................................................................................................##
##....................................................................................................##
##....................................................................................................##
##....................................................................................................##
##....................................................................................................##
##....................................................................................................##
##....................................................................................................##
##....................................................................................................##
################################################################################@@@#####################
################################################################################@@@#####################
