##...###########################################################################
##...###########################################################################
#...............................................................................
#...............................................................................
#...............................................................................
#.............................................................................##
#.............................................................................##
#.............................................................................##
#.............................................................................##
#.............................................................................##
#.............................................................................##
#.............................................................................##
#.............................................................................##
#.............................................................................##
#.............................................................................##
#.............................................................................##
#.............................................................................##
#.............................................................................##
#.............................................................................##
#.............................................................................##
#.............................................................................##
#.............................................................................##
#.............................................................................##
#.............................................................................##
#.............................................................................##
#.............................................................................##
#.............................................................................##
#.............................................................................##
#.............................................................................##
#.............................................................................##
#.............................................................................##
#.............................................................................##
#.............................................................................##
#.............................................................................##
#.............................................................................##
#.............................................................................##
#.............................................................................##
#.............................................................................##
#.............................................................................##
#.............................................................................##
#.............................................................................##
#.............................................................................##
#.............................................................................##
#.............................................................................##
#.............................................................................##
#.............................................................................##
#.............................................................................##
#.............................................................................##
#.............................................................................##
#.............................................................................##
#.............................................................................##
#.............................................................................##
#.............................................................................##
#.............................................................................##
#.............................................................................##
#.............................................................................##
#.............................................................................##
#...............................................................................
#...............................................................................
#...............................................................................
#.............................................................................##
#.............................................................................##
#.............................................................................##
#.............................................................................##
#.............................................................................##
#.............................................................................##
#.............................................................................##
#.............................................................................##
#.............................................................................##
#.............................................................................##
#.............................................................................##
#.............................................................................##
#.............................................................................##
#.............................................................................##
#.............................................................................##
#.............................................................................##
#.............................................................................##
#.............................................................................##
#.............................................................................##
################################################################################
