##################################################
#................................................#
#................................................#
#................................................#
#................................................#
#................................................#
#................................................#
#................................................#
#-----..............-------......................#
#.........------.................................#
#.............................-----..............#
#......................................----------#
#......................................==========#
#..................................--------------#
#~~~~~~~~#.........................==============#
#~~~~~~~~#--..................-------------------#
#~~~~~~~~#....................===================#
##################################################

[Entities]
Player=15,16