####################
####################
##.................#
...................#
...................#
...................#
##---..............#
##.................#
##.................#
############..######
##.................#
##.................#
###..###############
##.................#
##.................#
##########.........#
##.................#
##.................#
##.......###########
##.................#
##.................#
##.................#
###############....#
##.................#
##.................#
##.................#
########...#########
##.................#
##.................#
##.................#
####...#############
