#############################
#############################
.............................
.............................
#############################
#...........................#
#...........................#
#..............###..........#
#...........................#
#.............#####.........#
#............#######........#
#...........................#
#...........####.####.......#
#..........#####.#####......#
#...........................#
#.........######.######.....#
#........#######.#######....#
#...........................#
#......###################..#
#...........................#
#~~~~########################
#~~~~~~~~~~~~~~~~~~~~~~~~~~~~
#~~~~~~~~~~~~~~~~~~~~~~~~~~~~
#~~~~~~~~~~~~~~~~~~~~~~~~~~~~
#~~~~~~~~~~~~~~~~~~~~~~~~~~~~
#~~~~~~~~~~~~~~~~~~~~~~~~~~~~
#############################
