________....________
__.................#
_..................#
...................#
....###~~~~~~~~~~~~#
...###~~~~~~~~~~~~~#
..###~~~~~~~~~~~~~~#
.###~~~~~~~~~~~~~~~#
###~~~~~~~~~~~~~~~~#
##~~~~~~~~~~~~~~~~~#
#~~~~~~~~~~~~~~~~~~#
#~~~~~~~~~~~~~~~~~~#
#~~~~~~~~~~~~~~~~~~#
#~~~~~~~~~~~~~~~~~~#
#~~~~~~~~~~~~~~~~~~#
#~~~~#~~~~~~~~~~~~##
#~~~~~#~~~~~~~~~~###
#~~~~~~##~~~~~~~####
#~~~~~~~#~#~##~#~~~~
#~~~~~~~~#~#~~#~~~~~
#~~~~~~~#~~~~~~~~~~~
#~~~~~~~#~~~~~~~~~~~
#~~~~~~~#~~~~~~~~~~#
#~~~~~~~~#~~~~~~~~~#
#~~~~~~~#~~~~~~~~~~#
#~~~~~~~~##~~~~~~~~#
#~~~~~~~~~#~~~~~~~~#
#~~~~~~~~#~~~~~~~~~#
#~~~~~~~~~#~~~~~~###
#~~~~~~~~~~#~~~~#~~#
#~~~~~~~~##~~~~#~#~#
#~~~~~~~#~#~~~~~#~~#
#~~~~#~~#~~#~~~~~~~#
#~~~#~~~~~~#~~~~~~~#
#~~~~##~~~~~#~~~~~~#
#~~~~~~~~~~#~~~~~~~#
#~~#~~~~~~~~##~~~~~#
#~#~~~~~~~##~~#~~~~#
##~~~~~~#~~~#~~~~~~#
#~~~~~~#~#~#~~~~~~~#
#~~~~~#~~~#~~~~~~~~#
#~~~~#~~~~~~~~~~#~~#
#~~#~~#~~~~~~~##~~~#
#~~~##~~~~~~~#~~~~~#
#~~~~~#~~~~~~~#~~~~#
#~~~~#~~~~~~~#~~~~~#
#~~~#~~~~~~~~~#~~~~#
#~~~~~~~~~~~~~##~~~#
#~~~~~~~~~~~~~~~#~~#
#~~~~~~~~~#~~~~#~~~#
#~~~~#~~~~~~#~~~~~~#
#~~~~~#~~~~~~#~~~~~#
#~~~~~~#~~~~~~#~~~~#
#~~~~~~~#~#~##~#~~~#
#~~~~~~~~#~#~~#~~~~#
#~~~~~~~~~~~~~~~~~~#
#~~~~~~~~~~~~~~~~~~#
##~~~~~~~~~~~~~~~~~#
###~~~~~~~~~~~~~~~##
####################
