#@@@#######
#..........
#..........
####.......
#........##
#.........#
#.........#
#.....#####
#.........#
#.........#
#.........#
#.........#
######....#
#.........#
#.........#
#.........#
#.........#
#...#######
#.........#
#.........#
#.........#
#.........#
#######...#
#.........#
#.........#
#.........#
#.........#
#.........#
#...#######
#........##
#........##
