##.......#........#
##.......#.....####
##.......#...###..#
##.......#........#
##.......#........#
##.......#........#
##.......#######..#
##.......#........#
##.......#........#
##.......#........#
##.......#........#
##.......#...######
##.......#........#
##.......#........#
##.......#........#
##.......#........#
##.......#######..#
##.......#........#
##.......#........#
##.......#........#
##.......#........#
##.......#...######
##.......#........#
##.......#........#
##.......#........#
##.......#........#
##.......#----....#
##................#
##................#
##................#
##................#
##................#
###################
###################
