#########################################################################################@@@##########
#########################################################################################@@@##########
##......................#.......................#........................#..........................##
##......................#.......................#........................#...............---........##
##......................#.......................#........................#...............===........##
##......................#.......................#........................#...............===........##
########................#.......................#........................#...............===........##
##......................#.......................#........................#................--........##
##......................#.......................#........................#...#...........===........##
##..............##################......###################.......############...........=.=........##
##.......................................................................................===........##
##.......................................................................................===........##
##..............................................................---......................===........##
##.....-----......................................................---....................===........##
##.....................................---------.................................---.....===........##
##.............................................................................---.......===........##
##.....................--------..............................................---.........===........##
.........................................................................................--.........##
..........................................................------------...................===........##
.........................................................................................===........##
##.......--------........................................................................===........##
##.......========........................................................................===........##
##.......========........................................................................===........##
##.......=.=.====........................................................................===........##
##.......==..====........................................................................===........##
##.......==.=====........................................................................===........##
##.......========........------------.......--------.....................................===........##
##.......======.=........============.......========.....................................===........##
##.......======.=........============.......========.....................................===........##
##.......========........=========.==.......=.======......................................--........##
##.......===.====........=========..=.......=.===..=.....................................===........##
##.......===.====........============.......==.==.==.....................................===........##
##.......===.====........====.=======.......========........------------.................===........##
##.......===.====........==..========.......========........============.................===........##
##----...===.====........===.========.......========........============.................===........##
##.......===.=.==........======..====.......========........=========.--.................--.........##
##.......===.=.==........======..====.......===.====........========.===.................===........##
##.......=====.==........======..====.......===.====........===.========.................===........##
##.......===.=.==........======..====.......===.====........===.========.................===........##
##.......===...==........======..====.......===.====........===..=======.....#########...===.......###
##.......===..===........======...===.......===.====........====..======.................===.......###
##.......==...===........======...===.......==...===........===....=...=.................===.......###
##.......==.=.===........======...===.......==...===........=.=.========.................===.......###
##.......==...===........===.==...===.......===..===........=.=====...==.................===.......###
##.......==..====........===.==...===.......===..===........=...=....===.................===.......###
##.......==.=====........===.==...===.......===..===........==..=.====.=..............################
##.......==.=====........===..=...===.......===..===........==..=.====.=.................===.......###
.........==.=====........===..=...===.......===..===........==..=.=..=.=.................===.......###
.........==.=====........===..=...===.......===....=........==.==.=..=.=.................===.......###
.........========........=....=..====.......===..=.=........==.=.==..=.=.................===.......###
##.......========........=....=..====.......===.==.=........======.===.=.................===.......###
##....------=====........=....=..====.......===...==........===========----------........==........###
##....=====----==........=....=..====.......===..===........=====================........===.......###
##....========----......-----------==....------=====........======.==============........===.......###
##....============......=============....=====----==........=======.=============........===.......###
##....=.==========......========.====....========----.......=======..=======.====........=.=.......###
##....==.=========......========.====....============.......===============..====........===.......###
##....=======.====......=============....============....----------.=====.=...===........===.......###
##....=======..===......=============....==.=========....==========..====.=...===........===........##
##....========.===......=============....==..=====---....=.========....==.=...===.........==........##
##@@@@@@@@#===..==......===..======.=....===..=======....==.=======....==.==..===........===........##
##........#====.==......====.======.=....====.=======....==========....==..=..===........===........##
##........##======......====.======.=....====..====###########====#####========################.....##
##---@@---#=======......===========.=....=====.======....==========..###=========........===........##
##........#=======......===========.=....============....======.===..####========........===........##
##........#####===..##########====###########====###########==..=#########.======........===.......###
##........#===#===.-#...=====#-===#.=....===#===-#===....==#-=.==#=..######.=====........===......####
##---@@---#===#===..#...===.=#=.==#.=....===#====#===....==#=====#=..#######.====........==......#####
##........#===#===..#...===.=#=.==#.=....===#====#===....==#=====#=..########.===........===....######
##........#===#-==..#...===.=#=.=-#.=....===#-==.#.==....==#====-#=..#########===........===...#######
##........#=======......===.=======.=....=======..===....==========..##########==........===..########
##........#=======......===========.=....============....==========..###########=........===.#########
#########################################################################################---##########
#########################################################################################...##########
