########...##############################################################################...########
#..................#...............................................................................#
#------------------#....................................................................-----......#
#..................#...............................................................................#
#..................#...............................................................................#
#..................#-...............................................................---------......#
#..................#==.....................---...---...---...---...---...---................---....#
#..................#--.....................===...===...===...===...===...===.......................#
#..................#===....................--=...===...===...===...===...=--.....................--#
#..................#----...................===...===...===...===...=-=...===.......................#
#..................#.................----..===...=--...===...--=...===...===....................---#
#..................#......---..............===...===...===...===...===...===.......................#
#..................#.......................===...===...=-=...===...===...===.......................#
#..................#............-----......===...===...===...===...===...===................----...#
#..................#............=====......===...===...===...===...===...===.......................#
#..................#............-------....===...===...===...===...===...===.......................#
#..................#..................--...===...===...===...===...===...===........------......---#
#..................#.......................===...===...===...===...===...===.......................#
#..................#.......................===...===...===...===...===...===.......................#
#..................#....................#######################################....................#
#..................#.....#~~~~~~~~~~~~~#########################################~~~~~~~~~~~~~~#....#
#..................#.....#~~~~~~~~~~~~~~~~~~~~~~~#####################~~~~~~~~~~~~~~~~~~~~~~~~#....#
#..................#--...#~~~~~~~~~~~~~~~~~~~~~~~~~~~~~~~~~~~~~~~~~~~~~~~~~~~~~~~~~~~~~~~~~~~~#....#
#..................#.....#~~~~~~~~~~~~~~~~~~~~~~~~~~~~~~~~~~~~~~~~~~~~~~~~~~~~~~~~~~~~~~~~~~~~#....#
#..................#...--#~~~~~~~~~~~~~~~~~~~~~~~~~~~~~~~~~~~~~~~~~~~~~~~~~~~~~~~~~~~~~~~~~~~~#....#
#..................#.....#~~~~~~~~~~~~~~~~~~~~~~~~~~~~~~~~~~~~~~~~~~~~~~~~~~~~~~~~~~~~~~~~~~~~#....#
#..................#.....#~~~~~~~~~~~~~~~~~~~~~~~~~~~~~~~~~~~~~~~~~~~~~~~~~~~~~~~~~~~~~~~~~~~~#....#
#..................#...########################################################################....#
#..................#...............................................................................#
#..................#...............................................................................#
#..................#--.............................................................................#
#..................#==...........................................................................=.#
#..................#==...........................................................................==#
#..................#==.--.....................................................................--.==#
#..................#==...........................................................................==#
#..................#==.....------....-----....--.......................--....-----....------.....==#
#..................#==...........................................................................==#
#..................#==............................--...............--............................==#
#..................#==...........................................................................==#
#..................#==...........................................................................==#
#..................#==................................-----------................................==#
#..................#==...........................................................................==#
#..................#==...........................................................................==#
#..................#==.......................-----....-----------....-----.......................==#
#..................#==...........................................................................==#
#..................#==..........----------...................................----------..........==#
#..................#==...........................................................................==#
#..................#---------.............................................................---------#
#..................#=========.............................................................=========#
#...................-------------------.........................................-------------------#
#...................===================.........................................===================#
####################################################################################################
