________...._________
__.................##
_..................##
...................##
....###~~~~~~~~~~~~##
...###~~~~~~~~~~~~~##
..###~~~~~~~~~~~~~~##
.###~~~~~~~~~~~~~~~##
###~~~~~~~~~~~~~~~~##
##~~~~~~~~~~~~~~~~~##
#~~~~~~~~~~~~~~~~~~##
#~~~~~~~~~~~~~~~~~~##
#~~~~~~~~~~~~~~~~~~##
#~~~~~~~~~~~~~~~~~~##
#~~~~~~~~~~~~~~~~~~##
#~~~~#~~~~~~~~~~~~###
#~~~~~#~~~~~~~~~~####
#~~~~~~##~~~~~~~#####
#~~~~~~~#~#~##~#~~~~~
#~~~~~~~~#~#~~#~~~~~~
#~~~~~~~#~~~~~~~~~~~~
#~~~~~~~#~~~~~~~~~~~~
#~~~~~~~#~~~~~~~~~~##
#~~~~~~~~#~~~~~~~~~##
#~~~~~~~#~~~~~~~~~~##
#~~~~~~~~##~~~~~~~~##
#~~~~~~~~~#~~~~~~~~##
#~~~~~~~~#~~~~~~~~~##
#~~~~~~~~~#~~~~~~####
#~~~~~~~~~~#~~~~#~~##
#~~~~~~~~##~~~~#~#~##
#~~~~~~~#~#~~~~~#~~##
#~~~~#~~#~~#~~~~~~~##
#~~~#~~~~~~#~~~~~~~##
#~~~~##~~~~~#~~~~~~##
#~~~~~~~~~~#~~~~~~~##
#~~#~~~~~~~~##~~~~~##
#~#~~~~~~~##~~#~~~~##
##~~~~~~#~~~#~~~~~~##
#~~~~~~#~#~#~~~~~~~##
#~~~~~#~~~#~~~~~~~~##
#~~~~#~~~~~~~~~~#~~##
#~~#~~#~~~~~~~##~~~##
#~~~##~~~~~~~#~~~~~##
#~~~~~#~~~~~~~#~~~~##
#~~~~#~~~~~~~#~~~~~##
#~~~#~~~~~~~~~#~~~~##
#~~~~~~~~~~~~~##~~~##
#~~~~~~~~~~~~~~~#~~##
#~~~~~~~~~#~~~~#~~~##
#~~~~#~~~~~~#~~~~~~##
#~~~~~#~~~~~~#~~~~~##
#~~~~~~#~~~~~~#~~~~##
#~~~~~~~#~#~##~#~~~##
#~~~~~~~~#~#~~#~~~~##
#~~~~~~~~~~~~~~~~~~##
#~~~~~~~~~~~~~~~~~~##
##~~~~~~~~~~~~~~~~~##
###~~~~~~~~~~~~~~~###
#####################
#####################
