##################################################
.................................................#
.................................................#
........................................##########
##...............................................#
##...............................................#
##...............................................#
##..................----------...................#
##...............................................#
##...............................................#
######........................................####
##.###........................................##.#
##..##........................................#..#
##...#...........................................#
##...............................................#
##...............................................#
##...............................................#
##...............................................#
##...............................................#
##...............................................#
######........................................####
##.###........................................##.#
##..##........................................#..#
##...#.........-----..........-----..............#
##...............................................#
##...............................................#
##...............................................#
##...............................................#
##...............................................#
##...............................................#
..............................................####
..............................................##.#
..............................................#..#
##...............................................#
##...............................................#
##...............................................#
##...............................................#
##...............................................#
##...............................................#
##.............---------.........................#
##............................................####
##............................................##.#
##............................................#..#
###..............................................#
####.............................................#
#####............................................#
#####............................................#
####.............................................#
###..............................................#
##.................................------........#
##...............................................#
##...............................................#
##...............................................#
##...............................................#
##......................#........................#
##.....................##........................#
##....................###........................#
##...................####........................#
#########################.......................##
#########################......................###
###............................................###
##..............................................##
##...............................................#
##...............................................#
##...............................................#
##...............................................#
##...............................................#
##...............................................#
##...............................................#
##..................................-----........#
##...............................................#
##...............................................#
##...............................................#
##...............................................#
##...............................................#
##.......................#.......................#
##.......................##......................#
###......................###.....................#
####.....................####....................#
#####....................#########################
#####....................#########################
####............................................##
###..........-----...............................#
##...............................................#
##...............................................#
##...............................................#
##...............................................#
##...............................................#
##...............................................#
##...............................-----...........#
##...............................................#
##...............................................#
##...............................................#
##...............................................#
##.....................#.........................#
##....................##.........................#
##...................###.........................#
##..................####........................##
########################........................##
########################.......................###
###............................................###
##..............................................##
##..............................................##
##...............................................#
##...............................................#
##...............................................#
##...............................................#
##...............................................#
##...............................................#
##..........-----......-----.....-----...........#
##...............................................#
##...............................................#
##...............................................#
##...............................................#
##...............................................#
##...............................................#
##...............................................#
.......................................###########
.................................................#
.......................................###########
##.....................-----.....................#
##...............................................#
##...............................................#
##--.............................................#
##==.............................................#
##==.............................................#
##==.............................................#
##==.............................................#
##==.............................................#
#####.........................................####
##..###.....................................###..#
##....................-------....................#
##...............................................#
##...............................................#
##...............................................#
##...............................................#
##...............................................#
##......------....------...------....------......#
##......======....======...======....======......#
##......=.====....======...===.==....==.===......#
##......===..=....=.==--...====.=....=.====......#
##......===.==....=.====...=..===....===.==......#
##......======....======...=.====....==.===......#
##......======....======...======....==.===......#
##########==########=.#######==########==#########
##......==.===....====.=...======....======......#
##......=.====....====.=...==.===....==.===......#
##......======....==.===...=.====....=.==.=......#
##......======....======...======....======......#
##################################################
