##################################################
.................................................#
.................................................#
.................................................#
##...............................................#
##...............................................#
##...............................................#
##...............................................#
##...............................................#
##...............................................#
##...............................................#
##...............................................#
##...............................................#
##...............................................#
##...............................................#
##...............................................#
##...............................................#
##...............................................#
##...............................................#
##...............................................#
##...............................................#
##...............................................#
##...............................................#
##...............................................#
##...............................................#
##...............................................#
##...............................................#
##...............................................#
##...............................................#
##...............................................#
.................................................#
.................................................#
.................................................#
##...............................................#
##...............................................#
##...............................................#
##...............................................#
##...............................................#
##...............................................#
##...............................................#
##...............................................#
##...............................................#
##...............................................#
##...............................................#
##...............................................#
##...............................................#
##...............................................#
##...............................................#
##...............................................#
##...............................................#
##...............................................#
##...............................................#
##...............................................#
##...............................................#
##...............................................#
##...............................................#
##...............................................#
##...............................................#
##...............................................#
##...............................................#
##...............................................#
##...............................................#
##...............................................#
##...............................................#
##...............................................#
##...............................................#
##...............................................#
##...............................................#
##...............................................#
##...............................................#
##...............................................#
##...............................................#
##...............................................#
##...............................................#
##...............................................#
##...............................................#
##...............................................#
##...............................................#
##...............................................#
##...............................................#
##...............................................#
##...............................................#
##...............................................#
##...............................................#
##...............................................#
##...............................................#
##...............................................#
##...............................................#
##...............................................#
##...............................................#
##...............................................#
##...............................................#
##...............................................#
##...............................................#
##...............................................#
##...............................................#
##...............................................#
##...............................................#
##...............................................#
##...............................................#
##...............................................#
##...............................................#
##...............................................#
##...............................................#
##...............................................#
##...............................................#
##...............................................#
##...............................................#
##...............................................#
##...............................................#
##...............................................#
##...............................................#
##...............................................#
##...............................................#
##...............................................#
##...............................................#
##...............................................#
.................................................#
.................................................#
.................................................#
##...............................................#
##...............................................#
##...............................................#
##...............................................#
##...............................................#
##...............................................#
##...............................................#
##...............................................#
##...............................................#
##...............................................#
##...............................................#
##...............................................#
##...............................................#
##...............................................#
##...............................................#
##...............................................#
##...............................................#
##...............................................#
##...............................................#
##...............................................#
##...............................................#
##...............................................#
##...............................................#
##...............................................#
##...............................................#
##...............................................#
##...............................................#
##...............................................#
##...............................................#
##################################################
