#...##################################################################################################
#...##################################################################################################
#.................##..............................==========........................................##
#.................##..............................==.=======........................................##
#.................##..............................======.===........................................##
#.................##..............................---====..=........................................##
#..................................................========...........--........---.................##
#...................................................---=====..........==........===.................##
#....................................................====.==..........==........===.................##
#.................##..................................=.====..........==........===.................##
#.................##....................................----..........--........---...........------##
#.................##..................................................==........===...........======##
#.................##..................................................==........=.=...........====.=##
#.................##..................................................==........===...........=..===##
#.................##..................................................==........=-=...........=.====##
#.................##..................................................-.........===...........=====.##
#.................##..................................................==........===...........------##
#.................##..................................................==........===...........======##
#.................##..................................................==........=.=...........====.=##
###########################~~~~~~~~~~~~~~~######......................==........===...........======##
#.................##......##~~~~~~~~~~~~~##...........................==.........==...........------##
#.................##.......##~~~~~~~~~~###............................==........===...........======##
#.................##........##~~~~~~~~##..............................==........===...........===.==##
#.................##.........##########...............................==........===...........=.====##
#.................##.............................=....................-------------...........======##
#.................##...........................===..........#.........=============...........------##
#......----##~~~~~##~~~~~##...................==.=.........##.........=..======.===...........======##
#..........##~~~~~##~~~~~##...................=.=.........###.........=============...........=.==.=##
#..........##~~~~~##~~~~~##..................=====.......#########################################@@##
#..........##~~~~~##~~~~~####################################.........==.==..==.===...........======##
#----......##~~~~~##~~~~~#####........................................======.===.==...........==.===##
#..........##~~~~~##~~~~~####.........................................=============...........==.===##
#..........##~~~~~##~~~~~###..........................................=============...........=.==.=##
#..........##~~~~~##~~~~~##.................................#.........==.==.=======.......#...======##
#......----##~~~~~##~~~~~##.................................##........==.=====..===.......##..======##
#..........##~~~~~##~~~~~##.................................###.......=.=======.===.......###.------##
#..........##~~~~~##~~~~~##...........==....................####......=============.......####====.=##
#..........##~~~~~##~~~~~##...........=.==..................##################################=.===.##
#----......##~~~~~##~~~~~##...........=====................##.................................======##
#..........##~~~~~##~~~~~##...........=..===..............##..................................------##
#..........##~~~~~##~~~~~##...........==.=.==............##...................................===.==##
#..........##~~~~~##~~~~~##............=====............##....................................==.===##
##..##########~~######~~#####@@##########################.......#.............................======##
#..........##~~~~~~~~~~~~##............#####...................##.............................------##
#..........##~~~~~~~~~~~~##............####...................###.............................======##
#..........##~~~~~~~~~~~~##............###...................####.............................=..===##
#..........##~~~~~~~~~~~~##............##...................#####.............................====.=##
#########..##################@@##################..######################################@@###########
#......................................##.............................................................
#......................................##.............................................................
#......................................##.............................................................
######################################################################################################
