#......#########################################################################
#.............................................................................##
#--...........................................................................##
#.........................########............########........................##
#........................##......##..........##......##.................########
#--...................................................................###.....##
#.............................................................................##
#.............................................................................##
#--...........................................................................##
#.............................................................................##
###~~~~~~~~~~~~~~~###~~~~~~~~##~~~~~~~~##~~~~~~~~##~~~~~~~~~~~~~~~####.....#####
#~~~~~~~~~~~~~~~~~###~~~~~~~~##~~~~~~~~##~~~~~~~~##~~~~~~~~~~~~~~##.......##..##
#~~~~~~~~~~~~~~~~~###~~~~~~~~##~~~~~~~~##~~~~~~~~##~~~~~~~~~~~~~##.......##...##
##~~~~~~~~~~~~~~~~###~~~~~~~~##~~~~~~~~##~~~~~~~~##~~~~~~~~~~~~##.............##
###~~~~~~~~~~~~~~~###~~~~~~~~##~~~~~~~~##~~~~~~~~##~~~~~~~~~~~##..............##
####~~~~~~~~~~~~~~~##~~~~~~~~##~~~~~~~~##~~~~~~~~##~~~~~~~~~~##...............##
####~~~~~~~~~~~~~~~##~~~~~~~~##~~~~~~~~##~~~~~~~~##~~~~~~~~~##................##
####~~~~~~~~~~~~~~~##~~~~~~~~##~~~~~~~~##~~~~~~~~##~~~~~~~~##.........------..##
####~~~~~~~~~~~~~~~##~~~~~~~~##~~~~~~~~##~~~~~~~~##~~~~~~###..........======..##
###~~~~~~~~~~~~~~~~##~~~~~~~~##~~~~~~~~##~~~~~~~~##~~~~~##............======..##
###~~~~~~~~~~~~~~~###~~~~~~~~##~~~~~~~~####~~~~####~~~~~##....##############..##
####~~~~~~~~~~~~~~##############~~~~~~~####~~~~####~~~~~##....#...............##
#####~~~~~~~~###~~###############~~~~~#####~~~~####~~~~~##....#...............##
#####~~###~~~~######~~~~~~~~~######~~######~~~~####~~~~###..--#...............##
###################~~~~~~~~~~~#############~~~~####~~#####....#...............##
###################~~~~~~~~~~~~~~~~~~~~~~~~~~~~##########.....#...............##
###################~~~~~~~~~~~~~~~~~~~~~~~~~~~~#########......#......#@@@#######
####################~~~~~~~~~~#########################.....--#.....##@@@#######
######################################################........#...####@@@#######
