##@@@###########################################################################
##@@@###########################################################################
#...............................................................................
#...............................................................................
#...............................................................................
#---------....................................................................##
#.............................................................................##
#.............................................................................##
#.............................................................................##
#.............................................................................##
#.........------------......---------------.......------------......-------...##
#.........=.===.=..=..........===..==.==..........===..==.==..........==.===..##
#..........=.======............===..=.=............===.====............==.=...##
#...........==..==...............=..==..............==..==..............==....##
#...........=...==..............==..=...............==..=...............==....##
#...........=....=..............==..==...............=..==..............==....##
#...........==..==..............==..==..............==..==..............==....##
#...........==..==..............=...==..............==...=..............==....##
#............=..==..............==..==..............=...==...............=....##
#-..........==..=...............==...=..............==...=..............==....##
#...........==..==..............==..==..............==..==..............==....##
#...........==..==..............==..==..............==..==..............==....##
#-..#~~~~~##########~~~~~~~~~~##########~~~~~~~~~~##########~~~~~~~~~~##########
#...#~~~~~~########~~~~~~~~~~~~########~~~~~~~~~~~~########~~~~~~~~~~~~###....##
#...##~~~~~~######~~~~~~~~~~~~~~######~~~~~~~~~~~~~~######~~~~~~~~~~~~~~##....##
#-...##~~~~~~####~~~~~~~~~~~~~~~~####~~~~~~~~~~~~~~~~####~~~~~~~~~~~~~~~~###~~##
#.....##~~~~~~##~~~~~~~~~~~~~~~~~~##~~~~~~~~~~~~~~~~~~##~~~~~~~~~~~~~~~~~~##~~##
#......##~~~~~~~~~~~~~~~~~~~~~~~~~~~~~~~~~~~~~~~~~~~~~~~~~~~~~~~~~~~~~~~~~~~~~##
#-......##~~~~~~~~~~~~~~~~~~~~~~~~~~~~~~~~~~~~~~~~~~~~~~~~~~~~~~~~~~~~~~~~~~~~##
#........##~~~~~~~~~~~~~~~~~~~~~~~~~~~~~~~~~~~~~~~~~~~~~~~~~~~~~~~~~~~~~~~~~~~##
#.........######################################################################
#--...........................................................................##
#.............................................................................##
#.........................########............########........................##
#--......................##......##..........##......##.................########
#.....................................................................###.....##
#.............................................................................##
#--...........................................................................##
#.............................................................................##
#.............................................................................##
#--~~~~~~~~~~~~~~~~##~~~~~~~~##~~~~~~~~##~~~~~~~~##~~~~~~~~~~~~~~~####...#######
#~~~~~~~~~~~~~~~~~~##~~~~~~~~##~~~~~~~~##~~~~~~~~##~~~~~~~~~~~~~~##...........##
#~~~~~~~~~~~~~~~~~~##~~~~~~~~##~~~~~~~~##~~~~~~~~##~~~~~~~~~~~~~##............##
##~~~~~~~~~~~~~~~~~##~~~~~~~~##~~~~~~~~##~~~~~~~~##~~~~~~~~~~~~##.............##
###~~~~~~~~~~~~~~~~##~~~~~~~~##~~~~~~~~##~~~~~~~~##~~~~~~~~~~~##..............##
####~~~~~~~~~~~~~~~##~~~~~~~~##~~~~~~~~##~~~~~~~~##~~~~~~~~~~##...............##
#####~~~~~~~~~~~~~~##~~~~~~~~##~~~~~~~~##~~~~~~~~##~~~~~~~~~##................##
######~~~~~~~~~~~~~##~~~~~~~~##~~~~~~~~##~~~~~~~~##~~~~~~~~##.........------..##
#######~~~~~~~~~~~~##~~~~~~~~##~~~~~~~~##~~~~~~~~##~~~~~~###..........======..##
########~~~~~~~~~~~##~~~~~~~~##~~~~~~~~##~~~~~~~~##~~~~~~#............======..##
##########################################################....##############@@##
#.............................................................#...............##
#...........................................................###...............##
#.............................................................#...............##
#.............................................................#...............##
#############################..............................####...............##
#......................#....#.................................#.....#@@@########
#.....................##....####..............................#.....#...........
#.....................#.....#............................######...###...........
#...........................#.....................########..........#...........
##########..................############~~~~~~~~~~#.................#.........##
#........#............#~~~~~#~~~~~~~~~~~~~~~~~~~~~#~~~~~~~~~~~~~~####.........##
#........#............##~~~~#~~~~~~~~~~~~~~~~~~~~~#~~~~~~~~~~~~~~~~~#.........##
#........###...........#~~~~#~~~~~~~~~~~~~~~~~~~~~#~~~~~~~~~#########.........##
#........#.............#~~~~#~~~###################~~~~~~~~~~~~~~~~~#.........##
#........#.............#~~~~#~~~~~~~~~~~~~~~~~~~~~#~~~~~~~~~~~~~~~~~#.........##
#....#########.........#~~~~#~~~~~~~~~~~~~~~~~~~~~#~~~~~~~~~~~~~~~~~#.........##
#~~~##~~~#~~~##~~~~~~~~#~~~~#~~~~~~~~~~~~~~~~~~~~~#~~~~~~~~~~~~~~~~~####~~~~~~##
#~~~~~~~~#~~~~~~~~~~~~~#~~~~#~~~~~~~~~~~~~~~~~~~~~#~~~~~~~~~~~~~~~~~#~~~~~~~~~##
#~~~~~~~~#~~~~~~~~~~~~~#~~~~############~~~~~~~~~~##############~~~~#~~~~~~~~~##
#~~~~~~~~#~~~~~~~~~~~~~#~~~~~~~~~~~~~~~~~~~~~~~~~~~~~~~~~~~~~~~~~~~~#~~~~~~~~~##
#~~~~~~~~#~~~~~~~~~~~~~#~~~~~~~~~~~~~~~~~~~~~~~~~~~~~~~~~~~~~~~~~~~~#~~~~~~~~~##
#~~~~~~~~#~~~~~~~~~~~~~#~~~~~~~~~~~~~~~~~~~~~~~~~~~~~~~~~~~~~~~~~~~~#~~~~~~~~~##
#~~~~~~~~#~~~~~~~~~~~~~#~~~~~~~~~~~~~~~~~~~~~~~~~~~~~~~~~~~~~~~~~~~~#~~~~~~~~~##
#~~~~~~~~#~~~~~~~~~~~~~##############################################~~~~~~~~~##
#~~~~~~~~~~~~~~~~~~~~~~~~~~~~~~~~~~~~~~~~~~~~~~~~~~~~~~~~~~~~~~~~~~~~~~~~~~~~~##
#~~~~~~~~~~~~~~~~~~~~~~~~~~~~~~~~~~~~~~~~~~~~~~~~~~~~~~~~~~~~~~~~~~~~~~~~~~~~~##
#~~~~~~~~~~~~~~~~~~~~~~~~~~~~~~~~~~~~~~~~~~~~~~~~~~~~~~~~~~~~~~~~~~~~~~~~~~~~~##
#~~~~~~~~~~~~~~~~~~~~~~~~~~~~~~~~~~~~~~~~~~~~~~~~~~~~~~~~~~~~~~~~~~~~~~~~~~~~~##
################################################################################
