##############################################...###########
#........................#####################...###########
#........................#..............................#..#
#..#######################..............................#..#
#.............................###########################..#
#########..####################.....................#......#
#.....#.............................................#......#
#.....#............##############..#.......................#
|.....#............#...............###############.........#
|.....##############..........######................########
|..#..................###..####.....................#......#
|..#..................#.............##############..##.....#
#..##################################................#...#.#
#....................................................#####.#
#....................###########.#####################.....#
#########..###########.........#.....................#.....#
#......................##..###.#########.###############.###
########################.....#.............................#
#............................#.............................#
##########...###############################################
