#@@@#######
#..........
#..........
####.......
#.........#
#......####
#.........#
#.........#
#.........#
#.........#
#.........#
#.........#
#######...#
#.........#
#.........#
#.........#
#.........#
#.........#
#.........#
#######...#
#.........#
#.........#
#.........#
#.........#
#.........#
#.........#
#.........#
#.........#
#...#######
#........##
#........##
