####################################################
####################################################
##................................................##
##................................................##
##................................................##
##................................................##
##................................................##
##................................................##
##................................................##
##-----..............-------......................##
##.........------.................................##
##.............................-----..............##
##~~~~~~~~#--...........................----------##
##~~~~~~~~#.............@@@@............==========##
######~~~~#.........................--------------##
##~~~~~~~~#--.....@@@@@@............==============##
##~~~~~~~~#....................-------------------##
##~~~~~~~~#....................===================##
####################################################
####################################################