##################################################
#................................................|
#................................................|
#................................................|
#................................._@@@@__........#
#................................._.....______...#
#.................................|.........._...#
#.................................|.........._...#
#.................................|.........._...|
#................................._.........._...|
#.................................______....._...|
##########~~~~~~~~~~#####...........===_______...|
#~~~~~~~~~~~~~~~~~~~~~~~|...........========.....|
#~~~~~~~~~~~~~~~~~~~~~~~|...........========.....#
#~~~~~~~~~~~~~~~~~~~~~~~|..----.....========.....#
#~~~~~~~~~~~~~~~~~~~~~~~|...........========.....#
#~~~~~~~~~~~~~~~~~~~~~~~#...........========.....#
#~~~~~~~~~~~~~~~~~~~~~~~#...........========.....#
#~~~~~~~~~~~~~~~~~~~~~~~#.......----========.....|
#~~~~~~~~~~~~~~~~~~~~~~~#...........========.....|
#~~~~~~~~~##############|...........========.....|
#~~~~~~~~~~~~~~~~~~~~~~~|...........========.....|
#~~~~~~~~~~~~~~~~~~~~~~~|...........=----===.....|
#~~~~~~~~~~~~~~~~~~~~~~~|...........========.....#
#~~~~~~~~~~~~~~~~~~~~~~~|...........========.....#
#~~~~~~~~~~~~~~~~~~~~~~~#.....----..========.....#
#~~~~~~~~~~~~~~~~~~~~~~~#...........========.....#
#~~~~~~~~~~~~~~~~~~~~~~~#...........========.....#
#~~~~~~~~~~~~~~~~~~~~~~~#...........========.....#
##################################################
